R 1920 1080

NO ./extras/textures/N
SO ./extras/textures/S
WE ./extras/textures/W
EA ./extras/textures/E

F 77,92,245
C 163,208,230

        1111111111111111111111111
        1000000000110000000000001
        1011000001110000000000001
        1001000000000000000000001
111111111011000001110000000111001
100000000011000001110111111   111111
111101111111110111000000101 11
11110111111111011101010010111
10000011101010111000000100011
111111000N0000001100000010001
10000000000000001101010010001
10000011101010101110111100111
11110111 1110101 101111010001
11111111 1111111 111111111111
