R 256 256 

NO ./extras/textures/N
SO ./extras/textures/S
WE ./extras/textures/W
EA ./extras/textures/E

F 77,92,53
C 163,208,230

11111111
10000001
10000001
100000011111111111
10000E000000000001
110001000000000001
100100011111111111
11111111