R 1920 1080

EA ./extras/textures/redbrick.xpm
NO ./extras/textures/eagle.xpm
SO ./extras/textures/mossy.xpm
WE ./extras/textures/colorstone.xpm

F 77,92,53
C 163,208,230

111111111111111
100000000000001
100001000000001
101111111111111
1001
10N1
1001
1111
