R 256 256 

NO ./extras/textures/N
SO ./extras/textures/S
WE ./extras/textures/W
EA ./extras/textures/E

F 77,92,53
C 163,208,230

11111111
10000001
10000001
10000001
100N0001
11000101
10010001
11111111
