R 1920 1080

NO ./extras/textures/eagle.xpm
SO ./extras/textures/mossy.xpm
WE ./extras/textures/colorstone.xpm
EA ./extras/textures/redbrick.xpm

F 77,92,53
C 163,208,230

111111111111111111111111
100000000000000000000001
100001000000100000000001
100000000000000000000001
100000000000N00000000001
100000000000000000000001
100000000000000000000001
111111111111111111111111

