R 256 256 

NO ./extras/textures/N
SO ./extras/textures/S
WE ./extras/textures/W
EA ./extras/textures/E

F 77,92,53
C 163,208,230

11111111
10010001
110001011111111
100000000000001
100N00000000001
110001010000001
100100011111111
11111111
