R 256 256 

NO ./extras/textures/N
SO ./extras/textures/S
WE ./extras/textures/W
EA ./extras/textures/E

F 77,92,53
C 163,208,230

11111111
10000001
10000001
100000011
100E00001
110001001
100100011
11111111