R 256 256 

NO ./extras/textures/N
SO ./extras/textures/S
WE ./extras/textures/W
EA ./extras/textures/E

F 77,92,53
C 163,208,230

11111111
11000001
11000001
11000001
110N0001
10000001
10000001
11111111
